1111111111111
1000000000101
100C000E01101
1000000110101
1111000110001
1001000000101
1000000P00101
1111111111111
