111111111
100000001
1PCCCCCE1
100000001
111111111
