11111111111111
10000000000001
1PCCCCCCCCCCE1
10000000000001
11111111111111
