1111111111111
1000001000001
1010001010001
1010001010101
1010001010101
1111111111111
1000001000001
101010101PCE1
1010101011111
1010101000001
1111111111111
