111111111111111
100000000000001
100110010010101
101000101010101
101010111001001
101010101001001
100100101001001
100000PCE000001
111111111111111
