11111111111111111
10000000000000001
10011001101000101
1010001PCE0101001
10111011100010001
10001010000101001
10110001101000101
10000000000000001
11111111111111111
