1111111111111
1111110111111
1111110111111
1111111111111
10001PCE10001
1111111111111
1111110111111
1111110111111
1111111111111
