1111111111111
1111111111111
1111111111111
111111E111111
111111C111111
111111P111111
1111111111111
1111111111111
1111111111111
