1111111111111
1011111111101
1101111111011
1110111110111
11111ECP11111
1110111110111
1101111111011
1011111111101
1111111111111
