11111
1PCE111
100011111
1111111111
