11111111
10P0C001
1CC0AE01
11111111
