11111111
10P0C001
1CC00E00
11111111
11111111
