1111111111111
10010000000C111
1000110111
1P0011E0000011
11111111
