1111111X11111
1010000001
100001111100X
1P0011E000E01
111X111111111
