111111111111111111
10010000C0000000C1
100000000000000001
100000001100111001
100000000000000001
100000001110000011
1P001100E011000001
100110000110000011
111111111111111111
