1111111111111111111111111111111111111111
10010000C00000000000000000000001010000C1
1000000000000000011100000000000000000011
1000000000000000011100000000000000000011
1000000000000000000000000000000000000001
1000000011001110000000000000000000000001
1000000000000000011100000000000000000011
1000000000000000000000000000000000000001
1000000000000000011100000000000000000011
1P00000000000001100000000E01100000000001
1000000000000011000000000110000000000011
1111111111111111111111111111111111111111
