11111111
10P0C001
1CC00E01
11111111

