11111111
10PPC001
1CC00E01
11111111
