11111111
10P0C1C1
1CC00E11
11111111
