111111111
1P1000011
1E1000111
1C1011111
111111111
